2
QUICK
FOX
5
17
567
757
761
979
10 16
1 1
8 10
################
#.##.....###...#
#....###.###.###
###.##.#.###.###
###.##.#.......#
#......#######.#
#.######.#.....#
#...####.#.#####
#####........###
################